20 20
wwwwwwwwwwwwwwwwwwww
w.....w...w.....w..w
w....w....w.....w..w
w..g.w....w..wwww..w
w.....w...w....w...w
w..................w
w.............wwwwww
wwwwwwww...........w
w..................w
w...wwwwwwwwwwwwwwww
w..................w
wwwwwwwwwwwwwwwww..w
w...w.........w....w
w.s.w.........w....w
w...w..wwwww..w....w
w...w..w...w..w....w
w...w..w...w..w....w
w......wwwww..w....w
w......w...........w
wwwwwwwwwwwwwwwwwwww
